11111111111
1P0000000X1
11011C11011
11011C11011
1X0000000E1
11011C11011
11011C11011
1C0000000C1
11111111111