11111111111
10000000001
1P000000001
11111C11111
11111011111
100000000E1
11111C11111
11111011111
10C000000C1
11111111111