11111111111
1P0000000X1
11111C11111
11111C11111
1X0000000E1
11111C11111
11111C11111
1C0000000C1
11111111111