11111111111
1PX000000X1
10000000001
11111C11111
11111011111
100000000E1
11111C11111
11111011111
10C0000C001
11111111111