11111111111
1CE00000001
11000000001
11111C11111
11111011111
100000000P1
11111C11111
11111011111
10C000000C1
11111111111