1111111
1000001
100P001
1000001
1C000E1
1111111